5 5 5 5 5 5 5 5 5 5 5 5 5 5 5 5 5 5 5 5 
5 1 1 1 1 3 1 1 1 1 1 7 1 1 1 1 7 1 2 5
5 3 1 1 1 1 1 1 1 1 1 1 1 1 1 1 7 1 1 5
5 1 1 1 1 1 0 1 1 1 1 1 1 1 1 1 7 7 7 5
5 1 1 1 1 1 1 1 1 1 1 1 1 3 1 1 0 1 1 5

5 1 1 5 1 5 1 1 1 1 1 1 1 1 1 1 1 1 1 5
5 1 5 1 1 1 5 1 1 1 1 1 1 1 1 1 1 1 1 5
5 4 5 7 1 7 5 4 1 1 1 1 1 1 1 1 1 1 1 5
5 1 5 1 221 1 5 1 1 1 1 1 1 1 1 1 4 1 1 5
5 1 1 5 5 5 1 1 1 1 1 1 1 1 1 1 1 1 1 5

5 1 1 1 1 1 1 1 1 1 3 1 1 1 1 1 1 1 1 5
5 1 1 1 1 1 1 1 1 1 1 1 1 1 1 1 1 1 1 5
5 1 1 1 1 1 1 1 1 1 1 1 1 1 1 1 1 1 1 5
5 1 1 1 1 0 1 1 1 1 1 1 1 1 1 1 1 0 1 5
5 1 1 1 1 1 1 1 1 1 1 1 1 1 7 1 1 1 1 5

5 1 1 4 1 1 1 4 1 1 1 1 1 1 1 1 1 1 1 5
5 1 1 1 1 1 1 1 1 1 1 1 1 1 1 1 4 1 1 5
5 1 1 1 1 7 1 1 1 1 0 1 1 1 1 1 1 1 1 5
5 0 1 1 1 1 1 1 3 7 1 1 1 1 1 0 1 1 1 5
5 5 5 5 5 5 5 5 5 5 5 5 5 5 5 5 5 5 5 5