5 5 5 5 5 5 5 5 5 5 5 5 5 5 5 5 5 5 5 5
5 1 1 1 1 1 1 1 1 1 7 7 2 7 7 1 1 1 1 5
5 1 1 1 1 1 1 1 1 1 7 7 1 7 7 1 1 1 1 5
5 1 1 1 1 1 1 1 1 1 1 1 1 1 1 1 1 1 1 5
5 1 1 3 1 1 1 1 1 1 1 1 1 1 1 1 1 0 1 5

5 1 1 1 1 1 1 1 1 1 1 1 1 1 1 1 1 1 1 5
5 1 1 1 1 1 1 1 4 1 1 1 1 1 1 1 1 1 1 5
5 1 1 1 1 1 1 1 1 1 1 1 1 0 1 1 1 1 1 5
5 1 1 1 1 1 1 1 1 1 1 1 1 1 1 1 1 1 1 5
5 1 1 1 1 1 1 1 1 1 1 1 1 1 1 1 1 1 1 5

5 1 7 7 1 1 1 1 5 5 5 5 5 1 1 1 1 1 1 5
5 1 7 7 1 1 1 1 5 1 322 1 5 1 1 1 1 1 1 5
5 1 1 1 1 4 1 1 5 1 1 1 5 1 1 3 1 1 1 5
5 1 1 1 1 1 1 1 5 1 1 1 5 1 1 1 1 1 1 5
5 1 1 1 1 1 1 1 1 1 1 1 1 1 1 1 1 1 1 5

5 1 1 1 1 1 1 1 1 1 1 1 1 1 1 1 4 1 1 5
5 1 1 1 1 0 1 1 1 1 1 1 1 1 1 1 1 1 1 5
5 1 1 1 1 1 1 1 1 1 1 1 1 1 1 7 7 1 1 5
5 1 1 1 1 1 1 1 1 1 1 1 1 1 1 7 7 1 1 5
5 5 5 5 5 5 5 5 5 5 5 5 5 5 5 5 5 5 5 5









