5 5 5 5 5 5 5 5 5 5 5 5 5 5 5 5 5 5 5 5
5 0 0 1 1 1 1 1 1 1 1 1 1 1 1 1 5 1 1 5
5 1 1 1 1 1 1 1 1 0 0 1 1 1 1 1 1 1 1 5
5 5 5 7 1 1 1 1 1 0 0 1 1 1 1 1 1 1 1 5
5 1 1 1 1 1 1 1 1 1 1 1 1 7 7 1 1 1 1 5

5 1 1 1 1 7 0 7 1 1 1 1 1 1 1 1 1 1 0 5
5 1 1 1 1 1 1 1 1 1 1 1 1 1 1 1 1 1 1 5
5 1 1 4 4 4 1 1 1 1 1 1 1 0 1 1 1 1 1 5
5 1 1 4 7 4 1 1 1 1 1 1 1 1 1 1 1 1 1 5
5 1 1 1 1 1 1 1 1 1 1 1 1 1 1 1 1 1 1 5

5 1 1 1 1 1 1 1 1 1 1 1 1 1 1 1 1 1 1 5
5 5 5 5 5 1 1 1 1 1 1 1 1 7 4 7 1 1 1 5
5 7 2 1 7 1 1 1 1 0 1 1 1 4 4 4 1 1 1 5
5 7 1 1 7 1 1 1 1 0 1 1 1 7 4 7 1 1 1 5
5 7 7 1 1 1 1 1 1 1 1 1 1 1 1 1 1 1 1 5

5 7 7 1 1 1 1 1 1 1 1 1 1 1 1 1 7 7 7 5
5 1 1 1 1 1 1 1 5 5 5 1 1 1 1 1 7 423 0 5
5 1 1 1 1 1 1 1 5 7 5 1 1 1 1 1 1 1 0 5
5 0 1 1 1 1 1 1 1 1 1 1 1 1 1 7 7 0 0 5
5 5 5 5 5 5 5 5 5 5 5 5 5 5 5 5 5 5 5 5