5 5 5 5 5 5 5 5 5 5 5 5 5 5 5 5 5 5 5 5 
5 3 3 4 1 1 1 1 1 1 1 1 1 1 1 1 1 1 3 5
5 4 4 4 1 1 1 1 1 1 1 1 1 1 1 1 1 1 1 5
5 1 1 1 1 1 1 3 3 1 1 1 4 3 1 1 1 1 1 5
5 1 1 1 1 1 1 1 1 1 1 1 4 4 1 1 1 1 1 5

5 1 1 1 1 1 1 1 1 1 1 1 1 1 1 1 1 1 3 5
5 1 3 3 1 1 1 1 1 1 1 1 1 1 3 3 1 1 1 5
5 1 1 1 1 1 1 3 3 1 1 1 1 1 1 1 1 1 1 5
5 1 1 1 1 1 1 3 3 1 1 1 1 1 1 1 1 4 4 5
5 1 1 1 1 1 1 1 1 1 1 1 1 1 1 1 1 4 3 5

5 1 3 4 4 4 3 1 1 1 1 1 1 1 1 1 1 1 1 5
5 1 1 4 2 4 1 1 1 1 1 1 1 1 1 3 3 1 1 5
5 1 1 3 1 3 1 1 1 1 3 1 1 1 1 3 3 1 1 5
5 1 1 1 1 1 1 1 1 1 1 1 1 1 1 1 1 1 1 5
5 1 1 1 1 1 1 1 1 1 1 1 1 1 1 1 1 1 1 5

5 3 1 1 1 1 1 1 1 1 1 1 1 1 1 1 3 3 3 5
5 1 1 1 1 1 1 1 1 1 1 1 1 1 1 1 1 1 3 5
5 1 1 1 1 1 3 1 1 1 1 4 3 1 1 1 1 555 3 5
5 3 3 1 1 1 1 1 1 1 4 4 3 1 1 1 3 3 3 5
5 5 5 5 5 5 5 5 5 5 5 5 5 5 5 5 5 5 5 5